Claud	Faz
Michale	Bonetti
Telma	Falk
Rebbeca	Campana
Khalilah	Newberg
Reggie	Diep
Gussie	Tardiff
Malka	Brimmer
Thelma	Mcgraw
Brenda	Herrell
Ta	Alers
Rosette	Foti
Hiram	Daughtry
Kirk	Rhynes
Marita	Koprowski
Nelle	Hanlin
Griselda	Basch
Anton	Kile
Darrel	Puma
Haywood	Debartolo
Angela	Daughdrill
Elaine	Fruchter
Fredrick	Tomes
Nolan	Funes
Delana	Speaker
Hilario	Roache
Rosann	Cockburn
Soo	Armond
Marvis	Wrench
Coreen	Lal
Misha	Lastrapes
Drew	Deforge
Larisa	Rostad
Wilson	Stabler
Leota	Largent
Aliza	Creech
Leanora	Fazekas
Yuko	Trevathan
Cher	Ivy
Susanne	Cranford
Lynetta	Krumm
Pamela	Baptist
Russel	Finch
Jaimie	Hensen
Jerrie	Gilder
Renita	Midgette
Francie	Winter
Chieko	Lechler
Elenora	Flake
Twila	Tweedy

